	architect		architecte
	builder		maçon
	computer programmer		programmeur
	doctor		médecin
	engineer		ingénieur
	farmer		agriculteur
	firefighter		pompier
	flight attendant		membre de l’équipage (d’un avion)
	hairdresser		coiffeur
	mechanic		mécanicien
	nurse		infirmier
	vet		vétérinaire
	chemist’s pharmacie
	department store		grand magasin
	factory		usine
	fire station		caserne de pompiers
	garage		garage
	hospital		hôpital
	office		bureau
	petrol station		station-service
	police station		poste de police, commissariat
	railway station		gare ferroviaire
	travel agent’s		agence de voyages
	university		université
	earn		gagner
	full-time		à plein temps
	job		travail
	part-time		à temps partiel
	pay		payer
	pocket money		argent de poche
	save (money)		économiser (de l’argent)
	savings		économies
	spend		(spend money on sth) dépenser (de l’argent pour acheter qqch)
	spend money on cars		dépenser de l’argent pour les voitures
	work		travailler